F5
N0
N
1111111111111111
1111111111111111
0000000000000011
0000000000000011
0000000000000011
1111110000000011
1111110000000011
1111110000000011
1111100000000011
1111100000000011
1111100001100011
1111111111100011
1111111111100011