L4
N0
N
1111111111111111
1111111111111111
1100000000000000
1100000000000000
1100000000000000
1100000000000011
1100000000000011
1100000000000011
0000000000000011
0000000000000011
0000000000000011
1111111111111111
1111111111111111

