S4
N0
N
1111111111111111
0000011111111111
0000000000000111
0000000000000111
1100001010000111
1100000000000111
1100000000000111
1100000000000111
1100010101000111
1100000000000111
1100000000000111
1100000000000111
1111111111111111