F4
C4N0
N
1111111111111111
1111111111111111
1111100000011111
1111100000000111
1110000000000011
1110000000000011
0000000000000000
0000000000000000
0000000000000000
1100000000000111
1111000000011111
1111111111111111
1111111111111111