S3
C5N0
N
1111111111111111
1111111111111111
1100010000010000
1100010000010000
1100010010010000
1100010010000011
0000010010000011
0000010000010011
0000010000010011
1100010011110011
1100000010000011
1100000010000011
1111111111111111