S4
C4N0
N
1111111111111111
1111111111111111
1111111000000111
1110000000000111
0000000000000000
0000000000000000
0000000000000000
0000000000000000
1110000000111111
1110000111111111
1111111111111111
1111111111111111
1111111111111111