F4
H2N0
N
1110001111111111
1110001111111111
0000000000001111
0000000000001111
0000000000001111
1100000000001111
1100000000001111
1100000000001111
1100000000001111
1110000000011111
1110000000011111
1110001111111111
1110001111111111
