N0
N0
N
1111111111111111
0011111110000111
0001111000000111
0000110000000111
1000000000000111
1100000000001111
1100000000001111
1110000000011111
1110000000111111
1111000001111111
1111000011111111
1111000011111111
1111000011111111

