F3
C4N0
N
1111110001111111
1111110001000000
1110000001000000
1110000001000000
1110000001000111
1100000001000111
1100011111000111
1100011100000111
1100011000000111
1100000000000111
1100000000111111
1100000000111111
1111111111111111
