F3
C4H2
N
1111111111111111
1111100000111111
1111000000011111
1110000000001111
1100000000000111
1100000000000111
0000000000000111
0000000000000111
0000000000000111
1100000000000111
1110000000001111
1111000000011111
1111110001111111
