N0
C4H3
D
1111111111111111
1111111111111111
0000010000000011
0000010000000011
0000010000000011
1100010000100011
1100110000100011
1100100001100011
1100100001000011
1100100011000011
1100000010000011
1100000010000011
1111111111000111