N0
N0
N
1111111111111111
1111111111111111
1111110000000111
1110000000000111
0000000000000111
0000000000001111
0000000000001111
0000000000011111
1110000000011111
1110000011111111
1111000011111111
1111000011111111
1111000011111111