F6
N0
N
1111111111111111
1100000000000111
1100000000000000
1100000000000000
1100000000000000
1100000000000111
1100000000000111
1100000000000111
1100000000000111
1100000000000111
1100000000000111
1100000000000111
1111111111111111