F4
N0
N
1111111111111111
1111111111111111
1100000000000011
1100000000000011
1100011111100011
1100011111100011
1100011111100000
1100000000000000
1100000000000000
1100000000000011
1100000000000011
1100000000011111
1100011111111111