L2
N0
N
1100011111111111
1100000000011111
1100000000011111
1111100000011111
1111100000000011
1100000000000011
1100000000000000
1100000000000000
1100000000000000
1100000000000011
1100000000000011
1100000000011111
1111111111111111
