S3
N0
N
1111110001111111
1111110001000000
1110000001000000
1110000000000000
1110000000000111
1100000000000111
1100000000000111
1100000000000111
1100000000000111
1100000000001111
1100010000001111
1100010000001111
1111110001111111
