F4
N0
U
1100011111111111
1100011111111111
1100000000001111
1100000000001111
1100000000001111
1100000000000011
1100000000000011
1111000000000011
1111000000000000
1111000000000000
1111000000000000
1111111111111111
1111111111111111

