L3
N0
N
1110001111111111
1110001111111111
0000000000000000
0000000000000000
0000000000000000
1111110000000111
1111110000000111
1111100000001111
1111100000001111
1111000000011111
1111000000011111
1111111111111111
1111111111111111