N0
N0
N
1111111111111111
1111111111000000
1111111100000000
1111111100000000
1111111000000001
1111111000000111
1111110000011111
1111110000111111
1111100000111111
1111100001111111
1111000001111111
1111000011111111
1111000011111111