L3
N0
N
1111111111111111
1111111111111111
0000000000000000
0000000000000000
0000000000000000
1100000000000111
1100000000000111
1100000000000111
1100000000001111
1100000000001111
1110000000001111
1111111111111111
1111111111111111