N0
N0
N
1111111111111111
1111111111111111
1110000000011111
1110000000000011
1110000000000011
1110000000000011
1110000000000000
1110000000000000
1100000000000000
1100000000000011
1100000000011111
1100011111111111
1100011111111111