N0
N0
N
1100011111111111
1100000011111111
1100000000000111
1100000000000111
1100000000000000
1100000000000000
1100000000000000
1100000000000000
1100000000000111
1100000000111111
1100000011111111
1100011111111111
1111111111111111