N0
N0
N
1111111111000111
1111111111000111
1111000000000111
1111000000000111
1110000000000011
1110000000000011
0000000000000000
0000000000000000
0000000000000000
1100000000000111
1111000000001111
1111000000001111
1111111111111111