N0
N0
N
1111111111111111
1111111111111111
1100000000000011
1100000000000011
1100100000010011
1100000000000011
1100000000000011
1100001111000011
1110001111000111
1110000000000111
1110000000000111
1110001111111111
1110001111111111

