N0
N0
U
1111110001111111
1111110001111111
1110000000000111
1110000000000111
1111000000000111
1111000000000011
0000000000000011
0000000000000011
0000000000001111
1100000000001111
1111100000000111
1111100000000111
1111110001111111