F5
H2C4
N
1111111111100011
0000000000000001
0000000000000001
0000000000000001
1111000000000001
1111000000000001
1111000000000001
1111000000000001
1111000000000001
1111000000000001
1111000000000001
1111000000000001
1111111111111111